...........
..X..XX....
XXXXXX.....
X..........
.......XXX.
X..........